BBBBBBBBBBBBBBBBBBBB
BWWWWWWWBWWWWWWWWWWB
BBBWBWBWBBBBBWBWBBBB
BWWWWWWWWWBWBWBWBWBB
BWBWBBBWBWBWBWBBBWBB
BWWWBWWWBWWWBWBWBWWB
BBBBBWBWBBBBBWBBBWBB
BWBWWWBWWWWWWWWWBWBB
BWBWBWBWBWBBBBBWBBBB
BWWWBWBWBWBWBWWWWWBB
BWBWBWBWBWBWBWBWBWBB
BWBWWWBWBWBWWWWWWWWB
BWBWBBBWBBBBBWBWBWBB
BWWWBWWWWWBWWWWWWWWB
BBBBBBBBBBBBBBBBBBBB
