BBBBBBBBBBBBBBBBBBBB
BWBWWWWWWWWWWWWWWBWB
BWBBBWBWBWWBWBWBBBWB
BWWWBWBWWWWWWBWBWWWB
BBBBBBBBBWWBBBBBBBBB
BWWWBWWWWWWWWWWBWWWB
BWBWBBBBBWWBBBBBWBWB
BWWWBWWWWWWWWWWBWWWB
BBBWBBBWBWWBWBBBWBBB
BWBWBWBWWWWWWBWBWBWB
BWBBBWBWBWWBWBWBBBWB
BWBWBWWWWWWWWWWBWBWB
BWBWBBBWBWWBWBBBWBWB
BWWWWWBWWWWWWBWWWWWB
BBBBBBBBBBBBBBBBBBBB
