BBBBBBBBBBBBBBBBBBBB
BWBWWWWWWWWWWWWWBWWB
BWBWBWBBBWBBBBBWBBBB
BWWWBWBWBWWWBWWWWWWB
BWBWBBBWBWBBBWBWBWBB
BWWWWWBWWWWWWWBWBWWB
BWBBBWBBBWBBBWBBBWBB
BWWWBWWWBWWWBWWWWWBB
BWBBBBBWBBBWBBBBBBBB
BWBWBWWWWWWWBWWWWWBB
BWBWBBBBBBBWBBBBBWBB
BWBWBWWWWWBWBWBWBWBB
BWBBBBBWBWBWBBBBBBBB
BWWWWWWWWWWWWWWWBWWB
BBBBBBBBBBBBBBBBBBBB
