BBBBBBBBBBBBBBBBBBBB
BWWWWWWWWWWWWWWWWWWB
BWBWBWBWBWWBWBWBWBWB
BWBWBWWWBWWBWWWBWBWB
BWBWBWBBBWWBBBWBWBWB
BWBWWWBWBWWBWBWWWBWB
BWBBBWBWBWWBWBWBBBWB
BWBWBWWWWWWWWWWBWBWB
BWBWBBBWBWWBWBBBWBWB
BWBWWWBWBWWBWBWWWBWB
BWBBBWBWBWWBWBWBBBWB
BWWWBWWWWWWWWWWBWWWB
BWBWBBBBBWWBBBBBWBWB
BWWWWWWWBWWBWWWWWWWB
BBBBBBBBBBBBBBBBBBBB
