BWBWBWBWBWBWBWBWBWBW
WWWWWWWWWWWWBWWWWWWW
BWBWBBBWBWBWBWBWBBBW
WWBWBWWWWWBWBWWWBWWW
BWBWBWBBBBBBBWBWBBBW
WWWWBWWWBWWWBWWWWWBW
BWBWBWBBBBBWBBBBBBBW
WWBWBWBWBWWWWWBWWWWW
BWBWBWBWBWBWBBBWBWBW
WWWWWWBWWWBWBWBWBWWW
BBBBBWBWBWBWBBBBBBBW
WWWWBWWWBWBWWWBWWWWW
BWBWBWBBBWBWBBBBBBBW
WWWWWWWWWWWWBWWWWWBW
BBBBBBBBBBBBBBBBBBBW
