BBBBBBBBBBBBBBBBBBBB
BWWWWWWWWWBWWWWWWWWB
BWBWBBBWBWBBBBBWBWBB
BWBWWWBWWWBWBWWWWWBB
BWBWBWBBBWBWBWBWBWBB
BWBWBWBWBWWWWWWWWWWB
BWBWBWBWBBBWBBBBBWBB
BWBWWWWWBWWWWWBWWWWB
BWBWBWBWBBBBBWBBBBBB
BWWWBWWWWWWWWWWWBWWB
BWBWBWBWBWBBBBBWBBBB
BWBWBWBWWWWWWWWWWWBB
BWBWBWBBBWBWBBBBBBBB
BWBWWWWWWWWWWWWWWWWB
BBBBBBBBBBBBBBBBBBBB
