BBBBBBBBBBBBBBBBBBBB
BWWWWWWWWWBWBWWWWWWB
BWBWBWBWBWBWBWBBBWBB
BWBWBWWWBWBWBWBWWWBB
BWBWBWBBBWBBBWBBBWBB
BWBWWWBWBWWWWWBWBWWB
BWBBBWBWBBBBBWBWBBBB
BWBWBWWWWWWWWWBWWWBB
BWBWBBBWBBBBBBBWBWBB
BWBWWWBWBWWWBWWWBWWB
BWBBBWBWBBBWBBBWBBBB
BWWWBWWWWWBWBWWWWWBB
BWBWBBBBBWBWBWBWBBBB
BWWWWWWWBWWWWWBWWWWB
BBBBBBBBBBBBBBBBBBBB
