BWBWBWBWBWWBWBWBWBWB
BWWWWWWWWWWWWWWWWWWB
BWBWBBBWBWWBWBBBWBWB
BWBWBWWWWWWWWWWBWBWB
BWBWBWBBBWWBBBWBWBWB
BWWWBWWWBWWBWWWBWWWB
BWBWBWBBBWWBBBWBWBWB
BWBWBWBWBWWBWBWBWBWB
BWBWBWBWBWWBWBWBWBWB
BWWWWWBWWWWWWBWWWWWB
BBBBBWBWBWWBWBWBBBBB
BWWWBWWWBWWBWWWBWWWB
BWBWBWBBBWWBBBWBWBWB
BWWWWWWWWWWWWWWWWWWB
BBBBBBBBBBBBBBBBBBBB
